UEFA European Championship
UEFA Champions League
UEFA Europa League
UEFA Europa Conference League
UEFA Super Cup
UEFA Nations League
UEFA Euros
UEFA U-21 European Championship

Kategoria Superiore - Albania
Primera Divisió - Andorra
Armenian Premier League - Armenia
Austrian Bundesliga - Austria
Azerbaijan Premier League - Azerbaijan
Belarusian Premier League - Belarus
Belgian Pro League - Belgium
Beker Van Belgie - Belgium
Bosnian Premier League - Bosnia and Herzegovina
Bulgarian First League - Bulgaria
Croatian First Football League - Croatia
Cypriot First Division - Cyprus
Czech First League - Czech Republic
Danish Superliga - Denmark
Meistriliiga - Estonia
Faroe Islands Premier League - Faroe Islands
Veikkausliiga - Finland
Ligue 1 - France
Erovnuli Liga - Georgia
Bundesliga - Germany
DFB Pokal - Germany
Super League - Greece
Greek Cup - Greece
Nemzeti Bajnokság I - Hungary
Úrvalsdeild - Iceland
League of Ireland Premier Division - Ireland
Israeli Premier League - Israel
Serie A - Italy
Coppa Italia - Italy
Kazakhstan Premier League - Kazakhstan
Kosovo Superliga - Kosovo
Latvian Higher League - Latvia
Liechtenstein Cup - Liechtenstein
Pirma Lyga - Lithuania
Luxembourg National Division - Luxembourg
Maltese Premier League - Malta
Moldovan National Division - Moldova
Montenegrin First League - Montenegro
Eredivisie - Netherlands
KNVB Beker - Netherlands
Macedonian First Football League - North Macedonia
NIFL Premiership - Northern Ireland
Eliteserien - Norway
Ekstraklasa - Poland
Primeira Liga - Portugal
Liga I - Romania
Premier League - Russia
Campionato Sammarinese di Calcio - San Marino
Scottish Premiership - Scotland
Scottish Cup - Scotland
Serbian SuperLiga - Serbia
Slovak Super Liga - Slovakia
Slovenian PrvaLiga - Slovenia
La Liga - Spain
Copa Del Rey - Spain
Allsvenskan - Sweden
Svenska Cupen - Sweden
Swiss Super League - Switzerland
Swiss Cup - Switzerland
Süper Lig - Turkey
Turkish Cup - Turkey
Ukrainian Premier League - Ukraine
Premier League - United Kingdom
FA Cup - United Kingdom
EFL Cup - United Kingdom
Cymru Premier - Wales
Kosovo Superliga - Kosovo